5 5 5 5 5 5 5 5 5 5 5 5 5 5 5 5 5 5 5 5 5 5 5 5 5 
5 0 0 0 0 0 0 0 0 0 0 0 0 0 0 0 0 0 0 0 0 0 0 0 5 
5 3 4 4 4 4 4 4 4 4 4 4 6 6 6 4 4 4 4 4 4 4 4 6 5 
5 4 4 4 7 4 4 4 4 1 4 1 4 1 4 4 4 4 4 4 7 4 4 6 5 
5 4 4 7 3 7 4 4 4 4 4 4 4 4 4 4 4 4 4 7 6 7 4 6 5 
5 4 4 4 7 4 4 1 1 4 4 4 4 4 1 1 4 4 4 4 7 4 4 4 5 
5 4 4 4 4 4 4 1 3 4 5 5 5 4 6 1 4 1 4 4 4 4 4 4 5 
5 4 4 4 4 4 4 1 4 4 5 5 5 4 4 1 4 4 4 4 4 4 4 4 5 
5 4 4 4 4 4 4 1 6 4 0 2 0 4 3 1 4 1 4 4 4 4 4 4 5 
5 6 4 8 4 4 4 1 1 4 4 4 4 4 1 1 4 4 4 4 8 4 4 3 5 
5 6 8 3 8 4 4 4 4 4 4 8 4 4 4 4 4 4 4 8 3 8 4 3 5 
5 6 4 8 4 4 4 4 4 4 8 6 8 4 4 4 4 4 4 4 8 4 4 3 5 
5 4 4 4 4 4 4 4 4 4 4 8 4 4 4 4 4 4 4 4 4 4 4 4 5 
5 4 4 4 4 4 4 4 4 4 4 4 4 4 4 4 4 4 4 4 4 4 4 4 5 
5 5 5 5 5 5 5 5 5 5 5 5 5 5 5 5 5 5 5 5 5 5 5 5 5 
0 0 0 0 0 0 0 0 0 0 0 0 0 0 0 0 0 0 0 0 0 0 0 0 0 
